11111111111111111111111111111111111111
10000000000000000000000000000000000000
10000000000000000000000000000000000000
10000000000000000000000000000000000000
10000000000000111111110000000000000000
10000000000000000000000000000000000000
10000000000000000000000000000000000000
10000000000000000001111111000000000000
10000000000000000001111111000000000000
10000000000000000000000000000000000000
10000000000000000000000000000000000000
10000000000000000000000000000000000000
10000000000000000000000000000000000000
10000000000000000000000000000000000000
10000000000000000000000000000000000000
10000000000000000000000000000000000000
10000000000000000000000000000000000000
10000000000000000000000000000000000000